[
  [6, 6, 6, 6, 6, 6, 6, 6, 6, 6, 6, 6, 6, 6, 6, 6, 6, 6, 6, 6, 6, 6, 6, 6],
  [6, 45, 6, 6, 6, 6, 6, 6, 6, 6, 6, 6, 158, 159, 6, 6, 6, 6, 6, 6, 6, 6, 6, 6],
  [6, 0, 1, 1, 1, 1, 1, 2, 6, 6, 6, 47, 172, 173, 53, 6, 6, 6, 6, 6, 6, 6, 6, 6],
  [6, 14, 6, 6, 6, 6, 6, 14, 6, 6, 6, 6, 186, 187, 6, 6, 6, 6, 6, 6, 6, 6, 6, 6],
  [6, 14, 6, 6, 6, 6, 6, 28, 1, 1, 1, 1, 1, 1, 1, 1, 1, 1, 1, 1, 1, 2, 6, 6],
  [6, 14, 6, 66, 63, 6, 6, 6, 6, 48, 6, 6, 6, 6, 6, 6, 6, 6, 6, 6, 6, 14, 6, 6],
  [6, 14, 6, 64, 66, 61, 6, 6, 6, 6, 51, 49, 66, 6, 6, 6, 6, 6, 6, 6, 6, 14, 6, 6],
  [66, 14, 6, 62, 64, 6, 6, 6, 6, 6, 137, 138, 138, 139, 6, 6, 6, 6, 6, 6, 6, 6, 6, 6],
  [62, 14, 65, 66, 64, 6, 6, 6, 6, 6, 109, 152, 152, 153, 6, 6, 6, 6, 6, 6, 6, 6, 6, 6],
  [62, 14, 63, 61, 6, 6, 6, 6, 6, 6, 151, 152, 152, 153, 6, 6, 6, 6, 6, 6, 6, 6, 6, 6],
  [62, 14, 63, 61, 6, 6, 6, 6, 6, 6, 151, 152, 152, 153, 6, 6, 6, 6, 6, 6, 6, 6, 6, 6],
  [62, 14, 63, 61, 6, 6, 6, 6, 6, 6, 151, 152, 152, 153, 6, 6, 6, 6, 6, 6, 6, 6, 6, 6],
  [62, 14, 63, 61, 6, 6, 6, 6, 6, 6, 151, 152, 152, 153, 6, 6, 6, 6, 6, 6, 6, 6, 6, 6],
  [62, 14, 63, 61, 6, 6, 6, 6, 6, 6, 151, 152, 152, 153, 6, 6, 6, 6, 6, 6, 6, 6, 6, 6]
]
